X X X X X X X X X X X X
X 0 0 0 0 0 0 0 0 0 0 X
X 0 0 0 X X X X X X 0 X
X 0 0 0 X X X X X X 0 X
X 0 0 0 X X X X X X 0 X
X 0 0 0 X X X X X X 0 X
X 0 0 0 X X X X X X 0 X
X 0 0 0 X X X X X X 0 X
X X 0 0 X X X X X X 0 X
X X 0 0 X X X X X X 0 X
X X S 0 0 0 0 0 0 0 0 X
X X X X X X X X X X X X