2 . . . . 1
. 0 . 2 . .
. . . . 1 .
. 0 . . . 3
3 . . . 2 .
. 2 . . . 4